000000000000
01       rr0
0         r0
0 SE0      0
00000     r0
0rrr     rr0
000000000000